11 9
4 67 77 132 132 132 132 132 64 67 78
174 174 174 174 174 174 174 174 174 174 174
170 170 170 174 174 161 170 170 170 170 170
170 51 67 89 174 161 170 170 170 170 170
170 114 170 174 174 161 170 170 170 135 170
170 170 170 170 170 161 170 170 170 170 170
170 170 170 170 170 161 170 170 170 170 170
174 174 174 174 174 174 174 174 174 174 174
25 67 86 132 132 132 132 132 4 67 90