11 9
4 67 77 132 132 132 132 132 64 67 78
174 174 174 174 174 174 174 174 174 174 174
170 170 170 170 170 161 170 170 170 170 170
170 170 170 170 170 161 170 170 170 170 170
170 114 170 170 170 161 170 170 170 135 170
170 170 170 170 170 161 170 170 170 170 170
174 174 174 174 174 174 174 174 174 174 174
132 132 132 132 132 132 132 132 51 67 79
25 67 86 132 132 132 132 132 132 132 132