11 9
64 67 77 132 132 132 132 132 4 67 78
114 114 114 114 114 114 114 114 114 114 114
170 170 25 67 132 170 170 170 170 170 170
170 170 170 170 86 170 170 170 170 170 170
170 174 170 170 170 170 170 170 170 135 170
170 170 170 170 170 170 170 170 170 170 170
114 114 114 114 114 114 114 114 114 114 114
132 132 132 132 132 132 132 132 132 132 132
132 132 132 132 132 132 132 132 132 132 132